BBBBBBBBBBBBBBBBBBBBBBBBBBBB
BBBBBBBBBBBBBBBBBBBBBBBBBBBB
BB                        BB
BB                        BB
BB                       <BB
BB                      <?BB
BB                     <? BB
BB                    <?  BB
BB                   <?   BB
BB                  <?    BB
BB                 <?     BB
BB                 B      BB
BB                 B      BB
BB              <  B      BB
BB             <B  B      BB
BB            <?BBBB      BB
BB           <?           BB
BB          <?            BB
BB         <?             BB
BB        <?              BB
BB>      <?               BB
BB|>                      BB
BB |>                     BB
BB  |>                    BB
BB   |>                   BB
BB    |>                  BB
BB     |>                 BB
BB      |>                BB
BB       |>               BB
BB        |>              BB
BB         |>             BB
BB          |>            BB
BB           |>           BB
BB            |>          BB
BB             |>         BB
BB              |>        BB
BB                        BB
BB                        BB
BB                        BB
BB              >    >    BB
BB              |>   |>   BB
BB               |>   |>  BB
BB                |>   |> BB
BB                 |>   |>BB
BB                       BBB
BB                      <?BB
BB                     <? BB
BB                    <?  BB
BB                   <?   BB
BB                  <?    BB
BB                 <?     BB
BB                <?      BB
BB               <?       BB
BB              <?        BB
BB             <?         BB
BB            <?          BB
BB           <?           BB
BB>         <?            BB
BBB>       <?             BB
BBBB>     <?              BB
BBBBB>                    BB
BBBBBB>                   BB
BBBBBBB                   BB
BBBBBBB    BBBBBBBBBBBBBBBBB
BBBBBBB    BBBBBBBBBBBBBBBBB
BBBBBBB    BBBBBBBBBBBBBBBBB
BBBBBBB    BBBBBBBBBBBBBBBBB
BBBBBBB    BBBBBBBBBBBBBBBBB
BBBB                        
BBBB                        
BBBB                        
BBBB              BBBBBBBBBB
BBBB              BBBBBBBBBB
BBBB              BBBBBBBBBB
BBBB              BBBBBBBBBB
BBBB              BBBBBBBBBB
BBBB              BBBBBBBBBB
BBBB              BBBBBBBBBB
BBBB              BBBBBBBBBB
BBBB              BBBBBBBBBB
BBBB              BBBBBBBBBB
BBBB              BBBBBBBBBB
BBBBBBBBBBBBBBBBBBBBBBBBBBBB