BBBBBBBBBBBBBBBBBBBBBBBBBBBBBBBBBBBBBBB
BBBBBBBBBBBBBBBBBBBBBBBBBBBBBBBBBBBBBBB
         |BBBBBBBBBBBBBBBBBBBBBBBBBBBBB
          |BBBBBBBBBBBBBBBBBBBBBBBBBBBB
BB>        |BBBBBBBBBBBBBBBBBBBBBBBBBBB
BBB>        |BBBBBBBBBBBBBBBBBBBBBBBBBB
BBBB>        |BBBBBBBBBBBBBBBBBBBBBBBBB
BBBBB>        |BBBBBBBBBBBBBBBBBBBBBBBB
BBBBBB>        |BBBBBBBBBBBBBBBBBBBBBBB
BBBBBBB>        |BBBBBBBBBBBBBBBBBBBBBB
BBBBBBBB>        |BBBBBBBBBBBBBBBBBBBBB
BBBBBBBBB>        |BBBBBBBBBBBBBBBBBBBB
BBBBBBBBBB              |BBBBBBBBBBBBBB
BBBBBBBBBB               |BBBBBBBBBBBBB
BBBBBBBBBB                |BBBBBBBBBBBB
BBBBBBBBBB                 |BBBBBBBBBBB
BBBBBBBBBB    >             |BBBBBBBBBB
BBBBBBBBBB    B>             |BBBBBBBBB
BBBBBBBBBBWWWWBB>             |BBBBBBBB
BBBBBBBBBBBBBBBBB>             |BBBBBBB
BBBBBBBBBBBBBBBBBB>             |BBBBBB
BBBBBBBBBBBBBBBBBBB>             |BBBBB
BBBBBBBBBBBBBBBBBBBB>    >        |BBBB
BBBBBBBBBBBBBBBBBBBBB>   B>        |BBB
BBBBBBBBBBBBBBBBBBBBBB   BB>        |BB
BBBBBBBBBBBBBBBBBBBBBB   BBB>       ABB
BBBBBBBBBBBBBBBBBBBBB?   BBBB>      ABB
BBBBBBBBBBBBBBBBBBBB?    BBBBB>     ABB
BBBBBBBBBBBBBBBBBBB?     BBBBBB>    ABB
BBBBBBBBBBBBBBBBBB?     <BBBBBBBWWWWBBB
BBBBBBBBBBBBBBBBB?     <BBBBBBBBBBBBBBB
BB                    <BBBBBBBBBBBBBBBB
BB                   <BBBBBBBBBBB      
BB                  <BBBBBBBBBBBB      
BB        BBBBBBBBBBBBBBBBBBBBBBB    BB
BB        BBBBBBBBBBBBBBBBBBBBBBB    BB
BB        BBBBBBBBBBBBBBBBBBBBBBB    BB
BB        BBBBBBBBBBBBBBBBBBBBBBB    BB
BB        BBBBBBBBBBBBBBBBBBBBBBB    BB
BB        BBBBBBBBBBBBBBBBBBBBBBB    BB
BB        BBBBBBBBBBBBBBBBBBBBBBB    BB
BB        BB                         BB
BB        BB                         BB
BB        BB                         BB
BB        BB                     /BBBBB
BB        BB                    /BBBBBB
BB                             /BBBBBBB
BB                            /BBBBBBBB
BBBBBBBBBBBBBBBBBBBBBBBBBBBBBBBBBBBBBBB
BBBBBBBBBBBBBBBBBBBBBBBBBBBBBBBBBBBBBBB