BBBBBBBBBBBBBBB
B             B
B             B
B  /BBBBBBBBTTB
BOOBBBBBBBBBHHB
B  BBBBBBBBBHHB
B         HHHHB
B         HHHHB
B  /BBBBBBBBBBB
BBBBBBBBBBBBBBB