BBBBBBBBBBBBBBBBBBBBBBBBBBBBBBBBBBBBBBBBBBBBBBBB
BBBBBBBBBBBBBBBBBBBBBBBBBBBBBBBBBBBBBBBBBBBBBBBB
BBSS           ABBD                           BB
BB              BBD                           BB
BB              BBBBBBBB\                     BB
BB              BBBBBBBBB\                    BB
BBOOOOBBBBBB\                    /BBBBBOOOBBBBBB
BB    BBBBBBB\                  /BBBBBBBBBBBBBBB
BBBBOOBBBBBBBBBTTB\                           BB
BBBB  |BBBBBHHHHHHB\                          BB
BBB?   |BBBBHHHHHHBBBBBBBB?OOOO            /TTBB
BB?     |BBBBBBBBBBBBBBBB?                /BHHBB
BBOOOOOOO|BBBB?                          /BBHHBB
BB                                      /BBBHHBB
BB                       /BBBBBBBBBBBBBBBBBBHHBB
BB                      /BBBBBBBBBBBBBBBBBBBTTBB
BBOOBBBBBBBBBBBB\     /BBBBBBHHHHBBBB?   BBBHHBB
BB  BBBBBBBBBBBBBBBOOOBBBBBBBHHHHBBB?    BBBHHBB
BB  BBBBBBBBBBBBBBB     BBBBBHHBBBB      BBBHHBB
BBWWBBBBBBBBBBBBBBB        BBTTB         HHHHHBB
BBBBBBBBBBBBBBBBBBB                      HHHHHBB
BBBBBBBBBBBBBBBBBBB                      BBBBBBB
BBBBBBBBBBBBBBBBBBBBBBBBBBBBBBBBBBBBBBBBBBBBBBBB
BBBBBBBBBBBBBBBBBBBBBBBBBBBBBBBBBBBBBBBBBBBBBBBB